6
5
2 1
5 4
1 0 1 0 0 1
1 1 1 1 1 1
1 0 1 0 0 1
1 1 1 1 0 1
1 1 0 1 1 1